1,0,0,1,15,1, 1,0,1, 6,0,0,0,0,0,0
1,1,0,2,15,2,15,0,1,26,1,1,0,0,0,0
1,2,0,1,15,4,15,0,0, 0,2,9,0,1,0,2
1,3,0,2,15,3,15,0,3, 6,3,1,0,0,0,0
1,4,1,1, 1,2,15,1,2,24,0,0,0,0,0,0
1,5,1,2,15,3,15,0,1, 3,1,1,0,0,0,0
1,6,1,1, 1,3, 8,0,0, 0,3,1,0,2,0,2
1,7,3,0, 0,0, 0,0,0, 0,0,0,0,0,0,0
2,0,1,1,15,1, 1,1,1, 6,0,0,0,0,0,0
2,1,1,2,15,2,15,0,1,26,1,1,1,0,0,0
2,2,1,1,15,4,15,0,0, 0,2,9,1,1,0,3
2,3,1,2,15,3,15,0,3, 6,3,1,1,0,0,0
2,4,2,1, 1,2,15,1,2,24,0,0,0,0,0,0
2,5,2,2,15,3,15,0,1, 3,1,1,1,0,0,0
2,6,2,1, 1,3, 8,0,0, 0,3,1,1,2,0,3
2,7,3,0, 0,0, 0,0,0, 0,0,0,0,0,0,0
3,0,2,1,15,1, 1,1,1, 6,0,0,0,0,0,0
3,1,2,2,15,2,15,0,1,26,1,1,1,0,0,0
3,2,2,1,15,4,15,0,0, 0,2,9,1,1,0,4
3,3,2,2,15,3,15,0,3, 6,3,1,1,0,0,0
3,4,2,1, 1,2,15,1,2,24,0,0,0,0,0,0
3,5,2,2,15,3,15,0,1, 3,1,1,1,0,0,0
3,6,2,1, 1,3, 8,0,0, 0,3,1,1,2,0,4
3,7,3,0, 0,0, 0,0,0, 0,0,0,0,0,0,0
4,0,2,1,15,1, 1,1,1, 6,0,0,0,0,0,0
4,1,2,2,15,2,15,0,1,26,1,1,1,0,0,0
4,2,2,1,15,4,15,0,0, 0,2,9,1,1,1,1
4,3,2,2,15,3,15,0,3, 6,3,1,1,0,0,0
4,4,2,1, 1,2,15,1,2,24,0,0,0,0,0,0
4,5,2,2,15,3,15,0,1, 3,1,1,1,0,0,0
4,6,2,1, 1,3, 8,0,0, 0,3,1,1,2,1,1
4,7,3,0, 0,0, 0,0,0, 0,0,0,0,0,0,0
5,0,2,1,15,1, 1,1,1, 6,0,0,0,0,0,0
5,1,2,2,15,2,15,0,1,26,1,1,2,0,0,0
5,2,2,1,15,4,15,0,0, 0,2,9,2,1,1,2
5,3,2,2,15,3,15,0,3, 6,3,1,2,0,0,0
5,4,2,1, 1,2,15,1,2,24,0,0,0,0,0,0
5,5,2,2,15,3,15,0,1, 3,1,1,2,0,0,0
5,6,2,1, 1,3, 8,0,0, 0,3,1,2,2,1,2
5,7,3,0, 0,0, 0,0,0, 0,0,0,0,0,0,0
0,0,0,0, 0,0, 0,0,0, 0,0,0,0,0,0,0

