1,0,0,36,40,0,97,97,6,0,0,0,0,0
1,1,0,0,0,0,97,97,6,0,0,0,0,0
1,2,0,0,0,0,97,97,6,0,0,0,0,0
1,3,1,0,0,0,97,97,6,0,0,0,0,0
1,4,1,0,0,0,97,97,6,0,0,0,0,0
1,5,1,0,0,0,97,97,6,0,0,0,0,0
1,6,4,0,0,0,97,97,6,0,0,0,0,0
2,0,1,0,0,0,97,97,6,0,0,0,0,0
2,1,1,0,0,0,97,97,6,0,0,0,0,0
2,2,1,0,0,0,97,97,6,0,0,0,0,0
2,3,2,0,0,0,97,97,6,0,0,0,0,0
2,4,2,0,0,0,97,97,6,0,0,0,0,0
2,5,2,0,0,0,97,97,6,0,0,0,0,0
2,6,4,0,0,0,97,97,6,0,0,0,0,0
3,0,2,0,0,0,97,97,6,0,0,0,0,0
3,1,2,0,0,0,97,97,6,0,0,0,0,0
3,2,2,0,0,0,97,97,6,0,0,0,0,0
3,3,3,0,0,0,97,97,6,0,0,0,0,0
3,4,3,0,0,0,97,97,6,0,0,0,0,0
3,5,3,0,0,0,97,97,6,0,0,0,0,0
3,6,4,0,0,0,97,97,6,0,0,0,0,0
4,0,3,0,0,0,97,97,6,0,0,0,0,0
4,1,3,0,0,0,97,97,6,0,0,0,0,0
4,2,3,0,0,0,97,97,6,0,0,0,0,0
4,3,3,0,0,0,97,97,6,0,0,0,0,0
4,4,3,0,0,0,97,97,6,0,0,0,0,0
4,5,3,0,0,0,97,97,6,0,0,0,0,0
4,6,4,0,0,0,97,97,6,0,0,0,0,0
5,0,3,0,0,0,97,97,6,0,0,0,0,0
5,1,3,0,0,0,97,97,6,0,0,0,0,0
5,2,3,0,0,0,97,97,6,0,0,0,0,0
5,3,3,0,0,0,97,97,6,0,0,0,0,0
5,4,3,0,0,0,97,97,6,0,0,0,0,0
5,5,3,0,0,0,97,97,6,0,0,0,0,0
5,6,4,0,0,0,97,97,6,0,0,0,0,0
0,0,0,0,0,0,0,0,0,0,0,0,0,0

